..........................
..........................
..@@@@@@@@@@@@@@@@@@@@@@..
..@@..@@......##..##..##..
..@@..........##..##@@##..
..@@........####..##@@##..
..@@..##..........@@......
..@@..##..........@@......
..@@..##....@@....##%%##@@
..@@..##....@@....##%%##@@
..@@......##....@@..%%....
..@@......##....@@..%%....
..@@####%%%%%%@@....%%##..
..@@####%%%%%%@@....%%##..
..@@..@@%%##..##..##..##..
..@@..@@%%##..##..##..##..
..@@..@@..##..##......##..
..@@..@@..##..##......##..
..@@..##..######..##..##..
..@@..##..######..##..##..
..@@..##..######..........
..@@..##..................
..@@..............##..##..
..@@@@@@@@@@@##...##..##..
...........@..#...######..
...........@..#...######..